			DT	B'11111111',B'11111111';BTC=00
			DT	B'11111111',B'11111111';BTC=01
			DT	B'11111111',B'11111111';BTC=02
			DT	B'11111111',B'11111111';BTC=03
			DT	B'11111111',B'11111111';BTC=04
			DT	B'11111111',B'11111111';BTC=05
			DT	B'11111111',B'11111111';BTC=06
			DT	B'11111111',B'11111111';BTC=07
			DT	B'11111111',B'11111111';BTC=08
			DT	B'11111111',B'11111111';BTC=09
			DT	B'11111111',B'11111111';BTC=0A
			DT	B'11111111',B'11111111';BTC=0B
			DT	B'11111111',B'11111111';BTC=0C
			DT	B'11111111',B'11111111';BTC=0D
			DT	B'11111111',B'11111111';BTC=0E
			DT	B'11111111',B'11111111';BTC=0F